1111111111
10PC010E11
1111000111
1111000111
1111111111
