1111111111111111111111111111111111
111E0000K000000C00000CK00000000001
1P10010100100000101001000000010101
10100100101010100010010000K0010101
10C00K000C00C000000000000000000C01
1111111111111111111111111111111111
